TATACCTTCC	CAGGTAACAA	ACCAACCAAC	TTTCGATCTC
GTTCTCTAAA	CGAACTTTAA	AATCTGTGTG	GCTGTCACTC
TTAGTGCACT	CACGCAGTAT	AATTAATAAC	TAATTACTGT
ACACGAGTAA	CTCGTCTATC	TTCTGCAGGC	TGCTTACGGT
TTGCAGCCGA	TCATCAGCAC	ATCTAGGTTT	CGTCCGGGTG
GTAAGATGGA	GAGCCTTGTC	CCTGGTTTCA	ACGAGAAAAC
CTCAGTTTGC	CTGTTTTACA	GGTTCGCGAC	GTGCTCGTAC
AGACTCCGTG	GAGGAGGTCT	TATCAGAGGC	ACGTCAACAT
GCACTTGTGG	CTTAGTAGAA	GTTGAAAAAG	GCGTTTTGCC
CAGCCCTATG	TGTTCATCAA	ACGTTCGGAT	GCTCGAACTG
TCATGTTATG	GTTGAGCTGG	TAGCAGAACT	CGAAGGCATT
GTAGTGGTGA	GACACTTGGT	GTCCTTGTCC	CTCATGTGGG
GTGGCTTACC	GCAAGGTTCT	TCTTCGTAAG	AACGGTAATA
TGGCCATAGT	TACGGCGCCG	ATCTAAAGTC	ATTTGACTTA
TTGGCACTGA	TCCTTATGAA	GATTTTCAAG	AAAACTGGAA
AGCAGTGGTG	TTACCCGTGA	ACTCATGCGT	GAGCTTAACG
CACTCGCTAT	GTCGATAACA	ACTTCTGTGG	CCCTGATGGC
AGTGCATTAA	AGACCTTCTA	GCACGTGCTG	GTAAAGCTTC
TCCGAACAAC	TGGACTTTAT	TGACACTAAG	AGGGGTGTAT
TGAACATGAG	CATGAAATTG	CTTGGTACAC	GGAACGTTCT
ATGAATTGCA	GACACCTTTT	GAAATTAAAT	TGGCAAAGAA
TTCAATGGGG	AATGTCCAAA	TTTTGTATTT	CCCTTAAATT
GACTATTCAA	CCAAGGGTTG	AAAAGAAAAA	GCTTGATGGC
GAATTCGATC	TGTCTATCCA	GTTGCGTCAC	CAAATGAATG
TGCCTTTCAA	CTCTCATGAA	GTGTGATCAT	TGTGGTGAAA
GACGGGCGAT	TTTGTTAAAG	CCACTTGCGA	ATTTTGTGGC
TGACTAAAGA	AGGTGCCACT	ACTTGTGGTT	ACTTACCCCA
GTTAAAATTT	ATTGTCCAGC	ATGTCACAAT	TCAGAAGTAG
TAGTCTTGCC	GAATACCATA	ATGAATCTGG	CTTGAAAACC
AGGGTGGTCG	CACTATTGCC	TTTGGAGGCT	GTGTGTTCTC
TGCCATAACA	AGTGTGCCTA	TTGGGTTCCA	CGTGCTAGCG
TTGTAACCAT	ACAGGTGTTG	TTGGAGAAGG	TTCCGAAGGT
ACCTTCTTGA	AATACTCCAA	AAAGAGAAAG	TCAACATCAA
GACTTTAAAC	TTAATGAAGA	GATCGCCATT	ATTTTGGCAT
TTCCACAAGT	GCTTTTGTGG	AAACTGTGAA	AGGTTTGGAT
TCAAACAAAT	TGTTGAATCC	TGTGGTAATT	TTAAAGTTAC
GCTAAAAAAG	GTGCCTGGAA	TATTGGTGAA	CAGAAATCAA
TCTTTATGCA	TTTGCATCAG	AGGCTGCTCG	TGTTGTACGA
CCCGCACTCT	TGAAACTGCT	CAAAATTCTG	TGCGTGTTTT
GCTATAACAA	TACTAGATGG	AATTTCACAG	TATTCACTGA
TGCTATGATG	TTCACATCTG	ATTTGGCTAC	TAACAATCTA
CCTACATTAC	AGGTGGTGTT	GTTCAGTTGA	CTTCGCAGTG
ATCTTTGGCA	CTGTTTATGA	AAAACTCAAA	CCCGTCCTTG
AGAGAAGTTT	AAGGAAGGTG	TAGAGTTTCT	TAGAGACGGT
TTAAATTTAT	CTCAACCTGT	GCTTGTGAAA	TTGTCGGTGG
ACCTGTGCAA	AGGAAATTAA	GGAGAGTGTT	CAGACATTCT
AAATAAATTT	TTGGCTTTGT	GTGCTGACTC	TATCATTATT
AACTTAAAGC	CTTGAATTTA	GGTGAAACAT	TTGTCACGCA
TTGTACAGAA	AGTGTGTTAA	ATCCAGAGAA	GAAACTGGCC
TCTAAAAGCC	CCAAAAGAAA	TTATCTTCTT	AGAGGGAGAA
CAGAAGTGTT	AACAGAGGAA	GTTGTCTTGA	AAACTGGTGA
TTAGAACAAC	CTACTAGTGA	AGCTGTTGAA	GCTCCATTGG
AGTTTGTATT	AACGGGCTTA	TGTTGCTCGA	AATCAAAGAC
ACTGTGCCCT	TGCACCTAAT	ATGATGGTAA	CAAACAATAC
AAAGGCGGTG	CACCAACAAA	GGTTACTTTT	GGTGATGACA
AGTGCAAGGT	TACAAGAGTG	TGAATATCAC	TTTTGAACTT
TTGATAAAGT	ACTTAATGAG	AAGTGCTCTG	CCTATACAGT
ACAGAAGTAA	ATGAGTTCGC	CTGTGTTGTG	GCAGATGCTG
TTTGCAACCA	GTATCTGAAT	TACTTACACC	ACTGGGCATT
AGTGGAGTAT	GGCTACATAC	TACTTATTTG	ATGAGTCTGG
TTGGCTTCAC	ATATGTATTG	TTCTTTCTAC	CCTCCAGATG
AGAAGGTGAT	TGTGAAGAAG	AAGAGTTTGA	GCCATCAACT
ATGGTACTGA	AGATGATTAC	CAAGGTAAAC	CTTTGGAATT
TCTGCTGCTC	TTCAACCTGA	AGAAGAGCAA	GAAGAAGATT
TGATAGTCAA	CAAACTGTTG	GTCAACAAGA	CGGCAGTGAG
CAACTACTAT	TCAAACAATT	GTTGAGGTTC	AACCTCAATT
CTTACACCAG	TTGTTCAGAC	TATTGAAGTG	AATAGTTTTA
AAAACTTACT	GACAATGTAT	ACATTAAAAA	TGCAGACATT
CTAAAAAGGT	AAAACCAACA	GTGGTTGTTA	ATGCAGCCAA
AAACATGGAG	GAGGTGTTGC	AGGAGCCTTA	AATAAGGCTA
CATGCAAGTT	GAATCTGATG	ATTACATAGC	TACTAATGGA
TGGGTGGTAG	TTGTGTTTTA	AGCGGACACA	ATCTTGCTAA
CATGTTGTCG	GCCCAAATGT	TAACAAAGGT	GAAGACATTC
GAGTGCTTAT	GAAAATTTTA	ATCAGCACGA	AGTTCTACTT
TATCAGCTGG	TATTTTTGGT	GCTGACCCTA	TACATTCTTT
GTAGATACTG	TTCGCACAAA	TGTCTACTTA	GCTGTCTTTG
CTATGACAAA	CTTGTTTCAA	GCTTTTTGGA	AATGAAGAGT
TTGAACAAAA	GATCGCTGAG	ATTCCTAAAG	AGGAAGTTAA
ACTGAAAGTA	AACCTTCAGT	TGAACAGAGA	AAACAAGATG
CAAAGCTTGT	GTTGAAGAAG	TTACAACAAC	TCTGGAAGAA
TCACAGAAAA	CTTGTTACTT	TATATTGACA	TTAATGGCAA
GATTCTGCCA	CTCTTGTTAG	TGACATTGAC	ATCACTTTCT
TGCTCCATAT	ATAGTGGGTG	ATGTTGTTCA	AGAGGGTGTT
TGGTTATACC	TACTAAAAAG	GCTGGTGGCA	CTACTGAAAT
GCTTTGAGAA	AAGTGCCAAC	AGACAATTAT	ATAACCACTT
GGGTTTAAAT	GGTTACACTG	TAGAGGAGGC	AAAGACAGTG
GTAAAAGTGC	CTTTTACATT	CTACCATCTA	TTATCTCTAA
GAAATTCTTG	GAACTGTTTC	TTGGAATTTG	CGAGAAATGC
AGAAGAAACA	CGCAAATTAA	TGCCTGTCTG	TGTGGAAACT
TTTCAACTAT	ACAGCGTAAA	TATAAGGGTA	TTAAAATACA
GTTGATTATG	GTGCTAGATT	TTACTTTTAC	ACCAGTAAAA
GTCACTTATC	AACACACTTA	ACGATCTAAA	TGAAACTCTT
CACTTGGCTA	TGTAACACAT	GGCTTAAATT	TGGAAGAAGC
ATGAGATCTC	TCAAAGTGCC	AGCTACAGTT	TCTGTTTCTT
TGTTACAGCG	TATAATGGTT	ATCTTACTTC	TTCTTCTAAA
AACATTTTAT	TGAAACCATC	TCACTTGCTG	GTTCCTATAA
TATTCTGGAC	AATCTACACA	ACTAGGTATA	GAATTTCTTA
TAAAAGTGTA	TATTACACTA	GTAATCCTAC	CACATTCCAC
AAGTTATCAC	CTTTGACAAT	CTTAAGACAC	TTCTTTCTTT
AGGACTATTA	AGGTGTTTAC	AACAGTAGAC	AACATTAACC
AGTTGTGGAC	ATGTCAATGA	CATATGGACA	ACAGTTTGGT
TGGATGGAGC	TGATGTTACT	AAAATAAAAC	CTCATAATTC
AAAACATTTT	ATGTTTTACC	TAATGATGAC	ACTCTACGTG
TGAGTACTAC	CACACAACTG	ATCCTAGTTT	TCTGGGTAGG
CATTAAATCA	CACTAAAAAG	TGGAAATACC	CACAAGTTAA
TCTATTAAAT	GGGCAGATAA	CAACTGTTAT	CTTGCCACTG
ACTCCAACAA	ATAGAGTTGA	AGTTTAATCC	ACCTGCTCTA
ATTACAGAGC	AAGGGCTGGT	GAAGCTGCTA	ACTTTTGTGC
GCCTACTGTA	ATAAGACAGT	AGGTGAGTTA	GGTGATGTTA
GAGTTACTTG	TTTCAACATG	CCAATTTAGA	TTCTTGCAAA
ACGTGGTGTG	TAAAACTTGT	GGACAACAGC	AGACAACCCT
GAAGCTGTTA	TGTACATGGG	CACACTTTCT	TATGAACAAT
TGTTCAGATA	CCTTGTACGT	GTGGTAAACA	AGCTACAAAA
AACAGGAGTC	ACCTTTTGTT	ATGATGTCAG	CACCACCTGC
CTTAAGCATG	GTACATTTAC	TTGTGCTAGT	GAGTACACTG
GTGTGGTCAC	TATAAACATA	TAACTTCTAA	AGAAACTTTG
ACGGTGCTTT	ACTTACAAAG	TCCTCAGAAT	ACAAAGGTCC
GTTTTCTACA	AAGAAAACAG	TTACACAACA	ACCATAAAAC
TAAATTGGAT	GGTGTTGTTT	GTACAGAAAT	TGACCCTAAG
ATTATAAGAA	AGACAATTCT	TATTTCACAG	AGCAACCAAT
CCAAACCAAC	CATATCCAAA	CGCAAGCTTC	GATAATTTTA
TGATAATATC	AAATTTGCTG	ATGATTTAAA	CCAGTTAACT
AACCTGCTTC	AAGAGAGCTT	AAAGTTACAT	TTTTCCCTGA
GATGTGGTGG	CTATTGATTA	TAAACACTAC	ACACCCTCTT
AGCTAAATTG	TTACATAAAC	CTATTGTTTG	GCATGTTAAC
ATAAAGCCAC	GTATAAACCA	AATACCTGGT	GTATACGTTG
ACAAAACCAG	TTGAAACATC	AAATTCGTTT	GATGTACTGA
CGCGCAGGGA	ATGGATAATC	TTGCCTGCGA	AGATCTAAAA
AAGAAGTAGT	GGAAAATCCT	ACCATACAGA	AAGACGTTCT
GTGAAAACTA	CCGAAGTTGT	AGGAGACATT	ATACTTAAAC
TAGTTTAAAA	ATTACAGAAG	AGGTTGGCCA	CACAGATCTA
ATGTAGACAA	TTCTAGTCTT	ACTATTAAGA	AACCTAATGA
GTATTAGGTT	TGAAAACCCT	TGCTACTCAT	GGTTTAGCTG
TGTCCCTTGG	GATACTATAG	CTAATTATGC	TAAGCCTTTT
TTGTTAGTAC	AACTACTAAC	ATAGTTACAC	GGTGTTTAAA
ACTAATTATA	TGCCTTATTT	CTTTACTTTA	TTGCTACAAT
TACTAGAAGT	ACAAATTCTA	GAATTAAAGC	ATCTATGCCG
CAAAGAATAC	TGTTAAGAGT	GTCGGTAAAT	TTTGTCTAGA
AATTATTTGA	AGTCACCTAA	TTTTTCTAAA	CTGATAAATA
GTTTTTACTA	TTAAGTGTTT	GCCTAGGTTC	TTTAATCTAC
CTTTAGGTGT	TTTAATGTCT	AATTTAGGCA	TGCCTTCTTA
TACAGAGAAG	GCTATTTGAA	CTCTACTAAT	GTCACTATTG
TACTGGTTCT	ATACCTTGTA	GTGTTTGTCT	TAGTGGTTTA
ACACCTATCC	TTCTTTAGAA	ACTATACAAA	TTACCATTTC
TGGGATTTAA	CTGCTTTTGG	CTTAGTTGCA	GAGTGGTTTT
TCTTTTCACT	AGGTTTTTCT	ATGTACTTGG	ATTGGCTGCA
TGTTTTTCAG	CTATTTTGCA	GTACATTTTA	TTAGTAATTC
TGGTTAATAA	TTAATCTTGT	ACAAATGGCC	CCGATTTCAG
AATGTACATC	TTCTTTGCAT	CATTTTATTA	TGTATGGAAA
ATGTTGTAGA	CGGTTGTAAT	TCATCAACTT	GTATGATGTG
AATAGAGCAA	CAAGAGTCGA	ATGTACAACT	ATTGTTAATG
GTCCTTTTAT	GTCTATGCTA	ATGGAGGTAA	AGGCTTTTGC
ATTGGAATTG	TGTTAATTGT	GATACATTCT	GTGCTGGTAG
AGTGATGAAG	TTGCGAGAGA	CTTGTCACTA	CAGTTTAAAA
TCCTACTGAC	CAGTCTTCTT	ACATCGTTGA	TAGTGTTACA
GTTCCATCCA	TCTTTACTTT	GATAAAGCTG	GTCAAAAGAC
CATTCTCTCT	CTCATTTTGT	TAACTTAGAC	AACCTGAGAG
TAAAGGTTCA	TTGCCTATTA	ATGTTATAGT	TTTTGATGGT
GTGAAGAATC	ATCTGCAAAA	TCAGCGTCTG	TTTACTACAG
TGTCAACCTA	TACTGTTACT	AGATCAGGCA	TTAGTGTCTG
TAGTGCGGAA	GTTGCAGTTA	AAATGTTTGA	TGCTTACGTT
CATCAACTTT	TAACGTACCA	ATGGAAAAAC	TCAAAACACT
GCAGAAGCTG	AACTTGCAAA	GAATGTGTCC	TTAGACAATG
TTTTATTTCA	GCAGCTCGGC	AAGGGTTTGT	TGATTCAGAT
AAGATGTTGT	TGAATGTCTT	AAATTGTCAC	ATCAATCTGA
ACTGGCGATA	GTTGTAATAA	CTATATGCTC	ACCTATAACA
CATGACACCC	CGTGACCTTG	GTGCTTGTAT	TGACTGTAGT
TTAATGCGCA	GGTAGCAAAA	AGTCACAACA	TTGCTTTGAT
AAAGATTTCA	TGTCATTGTC	TGAACAACTA	CGAAAACAAA
TGCTAAAAAG	AATAACTTAC	CTTTTAAGTT	GACATGTGCA
AAGTTGTTAA	TGTTGTAACA	ACAAAGATAG	CACTTAAGGG
GTTAATAATT	GGTTGAAGCA	GTTAATTAAA	GTTACACTTG
TGTTGCTGCT	ATTTTCTATT	TAATAACACC	TGTTCATGTC
ATACTGACTT	TTCAAGTGAA	ATCATAGGAT	ACAAGGCTAT
GTCACTCGTG	ACATAGCATC	TACAGATACT	TGTTTTGCTA
TGATTTTGAC	ACATGGTTTA	GCCAGCGTGG	TGGTAGTTAT
AAGCTTGCCC	ATTGATTGCT	GCAGTCATAA	CAAGAGAAGT
GTGCCTGGTT	TGCCTGGCAC	GATATTACGC	ACAACTAATG
GCATTTCTTA	CCTAGAGTTT	TTAGTGCAGT	TGGTAACATC
CATCAAAACT	TATAGAGTAC	ACTGACTTTG	CAACATCAGC
GCTGCTGAAT	GTACAATTTT	TAAAGATGCT	TCTGGTAAGC
TTGTTATGAT	ACCAATGTAC	TAGAAGGTTC	TGTTGCTTAT
GCCCTGACAC	ACGTTATGTG	CTCATGGATG	GCTCTATTAT
AACACCTACC	TTGAAGGTTC	TGTTAGAGTG	GTAACAACTT
GTACTGTAGG	CACGGCACTT	GTGAAAGATC	AGAAGCTGGT
CTACTAGTGG	TAGATGGGTA	CTTAACAATG	ATTATTACAG
GGAGTTTTCT	GTGGTGTAGA	TGCTGTAAAT	TTACTTACTA
ACCACTAATT	CAACCTATTG	GTGCTTTGGA	CATATCAGCA
CTGGTGGTAT	TGTAGCTATC	GTAGTAACAT	GCCTTGCCTA
AGGTTTAGAA	GAGCTTTTGG	TGAATACAGT	CATGTAGTTG
TTTACTATTC	CTTATGTCAT	TCACTGTACT	CTGTTTAACA
CATTCTTACC	TGGTGTTTAT	TCTGTTATTT	ACTTGTACTT
CTTACTAATG	ATGTTTCTTT	TTTAGCACAT	ATTCAGTGGA
CACACCTTTA	GTACCTTTCT	GGATAACAAT	TGCTTATATC
CCACAAAGCA	TTTCTATTGG	TTCTTTAGTA	ATTACCTAAA
GTCTTTAATG	GTGTTTCCTT	TAGTACTTTT	GAAGAAGCTG
CTTTTTGTTA	AATAAAGAAA	TGTATCTAAA	GTTGCGTAGT
TACCTCTTAC	GCAATATAAT	AGATACTTAG	CTCTTTATAA
TATTTTAGTG	GAGCAATGGA	TACAACTAGC	TACAGAGAAG
TCATCTCGCA	AAGGCTCTCA	ATGACTTCAG	TAACTCAGGT
TTTACCAACC	ACCACAAACC	TCTATCACCT	CAGCTGTTTT
TTTAGAAAAA	TGGCATTCCC	ATCTGGTAAA	GTTGAGGGTT
AGTAACTTGT	GGTACAACTA	CACTTAACGG	TCTTTGGCTT
TTTACTGTCC	AAGACATGTG	ATCTGCACCT	CTGAAGACAT
AATTATGAAG	ATTTACTCAT	TCGTAAGTCT	AATCATAATT
GGCTGGTAAT	GTTCAACTCA	GGGTTATTGG	ACATTCTATG
TACTTAAGCT	TAAGGTTGAT	ACAGCCAATC	CTAAGACACC
TTTGTTCGCA	TTCAACCAGG	ACAGACTTTT	TCAGTGTTAG
TGGTTCACCA	TCTGGTGTTT	ACCAATGTGC	TATGAGGCCC
TTAAGGGTTC	ATTCCTTAAT	GGTTCATGTG	GTAGTGTTGG
GATTATGACT	GTGTCTCTTT	TTGTTACATG	CACCATATGG
TGGAGTTCAT	GCTGGCACAG	ACTTAGAAGG	TAACTTTTAT
TTGACAGGCA	AACAGCACAA	GCAGCTGGTA	CGGACACAAC
AATGTTTTAG	CTTGGTTGTA	CGCTGCTGTT	ATAAATGGAG
TCTCAATCGA	TTTACCACAA	CTCTTAATGA	CTTTAACCTT
AGTACAATTA	TGAACCTCTA	ACACAAGACC	ATGTTGACAT
CTTTCTGCTC	AAACTGGAAT	TGCCGTTTTA	GATATGTGTG
AGAATTACTG	CAAAATGGTA	TGAATGGACG	TACCATATTG
TATTAGAAGA	TGAATTTACA	CCTTTTGATG	TTGTTAGACA
GTTACTTTCC	AAAGTGCAGT	GAAAAGAACA	ATCAAGGGTA
GTTGTTACTC	ACAATTTTGA	CTTCACTTTT	AGTTTTAGTC
AATGGTCTTT	GTTCTTTTTT	TTGTATGAAA	ATGCCTTTTT
ATGGGTATTA	TTGCTATGTC	TGCTTTTGCA	ATGATGTTTG
GCATGCATTT	CTCTGTTTGT	TTTTGTTACC	TTCTCTTGCC
ATTTTAATAT	GGTCTATATG	CCTGCTAGTT	GGGTGATGCG
TGGTTGGATA	TGGTTGATAC	TAGTTTGTCT	GGTTTTAAGC
TGTTATGTAT	GCATCAGCTG	TAGTGTTACT	AATCCTTATG
CTGTGTATGA	TGATGGTGCT	AGGAGAGTGT	GGACACTTAT
ACACTCGTTT	ATAAAGTTTA	TTATGGTAAT	GCTTTAGATC
CATGTGGGCT	CTTATAATCT	CTGTTACTTC	TAACTACTCA
CAACTGTCAT	GTTTTTGGCC	AGAGGTATTG	TTTTTATGTG
TGCCCTATTT	TCTTCATAAC	TGGTAATACA	CTTCAGTGTA
TTATTGTTTC	TTAGGCTATT	TTTGTACTTG	TTACTTTGGC
TACTCAACCG	CTACTTTAGA	CTGACTCTTG	GTGTTTATGA
TCTACACAGG	AGTTTAGATA	TATGAATTCA	CAGGGACTAC
GAATAGCATA	GATGCCTTCA	AACTCAACAT	TAAATTGTTG
GCAAACCTTG	TATCAAAGTA	GCCACTGTAC	AGTCTAAAAT
AAGTGCACAT	CAGTAGTCTT	ACTCTCAGTT	TTGCAACAAC
ATCATCATCT	AAATTGTGGG	CTCAATGTGT	CCAGTTACAC
TCTTAGCTAA	AGATACTACT	GAAGCCTTTG	AAAAAATGGT
TCTGTTTTGC	TTTCCATGCA	GGGTGCTGTA	GACATAAACA
AGAAATGCTG	GACAACAGGG	CAACCTTACA	AGCTATAGCC
GTTCCCTTCC	ATCATATGCA	GCTTTTGCTA	CTGCTCAAGA
CAGGCTGTTG	CTAATGGTGA	TTCTGAAGTT	GTTCTTAAAA
GTCTTTGAAT	GTGGCTAAAT	CTGAATTTGA	CCGTGATGCA
GTAAGTTGGA	AAAGATGGCT	GATCAAGCTA	TGACCCAAAT
GCTAGATCTG	AGGACAAGAG	GGCAAAAGTT	ACTAGTGCTA
GCTTTTCACT	ATGCTTAGAA	AGTTGGATAA	TGATGCACTC
TCAACAATGC	AAGAGATGGT	TGTGTTCCCT	TGAACATAAT
ACAGCAGCCA	AACTAATGGT	TGTCATACCA	GACTATAACA
TACGTGTGAT	GGTACAACAT	TTACTTATGC	ATCAGCATTG
AACAGGTTGT	AGATGCAGAT	AGTAAAATTG	TTCAACTTAG
ATGGACAATT	CACCTAATTT	AGCATGGCCT	CTTATTGTAA
GGCCAATTCT	GCTGTCAAAT	TACAGAATAA	TGAGCTTAGT
TACGACAGAT	GTCTTGTGCT	GCCGGTACTA	CACAAACTGC
GACAATGCGT	TAGCTTACTA	CAACACAACA	AAGGGAGGTA
TGCACTGTTA	TCCGATTTAC	AGGATTTGAA	ATGGGCTAGA
GTGATGGAAC	TGGTACTATC	TATACAGAAC	TGGAACCACC
GTTACAGACA	CACCTAAAGG	TCCTAAAGTG	AAGTATTTAT
AGGATTAAAC	AACCTAAATA	GAGGTATGGT	ACTTGGTAGT
CAGTACGTCT	ACAAGCTGGT	AATGCAACAG	AAGTGCCTGC
GTATTATCTT	TCTGTGCTTT	TGCTGTAGAT	GCTGCTAAAG
TTATCTAGCT	AGTGGGGGAC	AACCAATCAC	TAATTGTGTT
GTACACACAC	TGGTACTGGT	CAGGCAATAA	CAGTTACACC
ATGGATCAAG	AATCCTTTGG	TGGTGCATCG	TGTTGTCTGT
CCACATAGAT	CATCCAAATC	CTAAAGGATT	TTGTGACTTA
ATGTACAAAT	ACCTACAACT	TGTGCTAATG	ACCCTGTGGG
AAAAACACAG	TCTGTACCGT	CTGCGGTATG	TGGAAAGGTT
TTGTGATCAA	CTCCGCGAAC	CCATGCTTCA	GTCAGCTGAT
TTTTAAACGG	GTTTGCGGTG	TAAGTGCAGC	CCGTCTTACA
CAGGCACTAG	TACTGATGTC	GTATACAGGG	CTTTTGACAT
AAAGTAGCTG	GTTTTGCTAA	ATTCCTAAAA	ACTAATTGTT
AGAAAAGGAC	GAAGATGACA	ATTTAATTGA	TTCTTACTTT
GACACACTTT	CTCTAACTAC	CAACATGAAG	AAACAATTTA
AAGGATTGTC	CAGCTGTTGC	TAAACATGAC	TTCTTTAAGT
CGGTGACATG	GTACCACATA	TATCACGTCA	ACGTCTTACT
TGGCAGACCT	CGTCTATGCT	TTAAGGCATT	TTGATGAAGG
ACATTAAAAG	AAATACTTGT	CACATACAAT	TGTTGTGATG
CAATAAAAAG	GACTGGTATG	ATTTTGTAGA	AAACCCAGAT
TATACGCCAA	CTTAGGTGAA	CGTGTACGCC	AAGCTTTGTT
CAATTCTGTG	ATGCCATGCG	AAATGCTGGT	ATTGTTGGTG
AGATAATCAA	GATCTCAATG	GTAACTGGTA	TGATTTCGGT
AAACCACGCC	AGGTAGTGGA	GTTCCTGTTG	TAGATTCTTA
TTAATGCCTA	TATTAACCTT	GACCAGGGCT	TTAACTGCAG
TGACACTGAC	TTAACAAAGC	CTTACATTAA	GTGGGATTTG
ACTTCACGGA	AGAGAGGTTA	AAACTCTTTG	ACCGTTATTT
GATCAGACAT	ACCACCCAAA	TTGTGTTAAC	TGTTTGGATG
TCTGCATTGT	GCAAACTTTA	ATGTTTTATT	CTCTACAGTG
CAAGTTTTGG	ACCACTAGTG	AGAAAAATAT	TTGTTGATGG
GTAGTTTCAA	CTGGATACCA	CTTCAGAGAG	CTAGGTGTTG
GGATGTAAAC	TTACATAGCT	CTAGACTTAG	TTTTAAGGAA
ATGCTGCTGA	CCCTGCTATG	CACGCTGCTT	CTGGTAATCT
AAACGCACTA	CGTGCTTTTC	AGTAGCTGCA	CTTACTAACA
TCAAACTGTC	AAACCCGGTA	ATTTTAACAA	AGACTTCTAT
TGTCTAAGGG	TTTCTTTAAG	GAAGGAAGTT	CTGTTGAATT
TTCTTTGCTC	AGGATGGTAA	TGCTGCTATC	AGCGATTATG
TTATAATCTA	CCAACAATGT	GTGATATCAG	ACAACTACTA
AAGTTGTTGA	TAAGTACTTT	GATTGTTACG	ATGGTGGCTG
AACCAAGTCA	TCGTCAACAA	CCTAGACAAA	TCAGCTGGTT
TAAATGGGGT	AAGGCTAGAC	TTTATTATGA	TTCAATGAGT
AAGATGCACT	TTTCGCATAT	ACAAAACGTA	ATGTCATCCC
CAAATGAATC	TTAAGTATGC	CATTAGTGCA	AAGAATAGAG
AGCTGGTGTC	TCTATCTGTA	GTACTATGAC	CAATAGACAG
AATTATTGAA	ATCAATAGCC	GCCACTAGAG	GAGCTACTGT
ACAAGCAAAT	TCTATGGTGG	TTGGCACAAC	ATGTTAAAAA
TGATGTAGAA	AACCCTCACC	TTATGGGTTG	GGATTATCCT
GAGCCATGCC	TAACATGCTT	AGAATTATGG	CCTCACTTGT
AAACATACAA	CGTGTTGTAG	CTTGTCACAC	CGTTTCTATA
TGAGTGTGCT	CAAGTATTGA	GTGAAATGGT	CATGTGTGGC
ATGTTAAACC	AGGTGGAACC	TCATCAGGAG	ATGCCACAAC
AATAGTGTTT	TTAACATTTG	TCAAGCTGTC	ACGGCCAATG
TTTATCTACT	GATGGTAACA	AAATTGCCGA	TAAGTATGTC
AACACAGACT	TTATGAGTGT	CTCTATAGAA	ATAGAGATGT
TTTGTGAATG	AGTTTTACGC	ATATTTGCGT	AAACATTTCT
ACTCTCTGAC	GATGCTGTTG	TGTGTTTCAA	TAGCACTTAT
GTCTAGTGGC	TAGCATAAAG	AACTTTAAGT	CAGTTCTTTA
AATGTTTTTA	TGTCTGAAGC	AAAATGTTGG	ACTGAGACTG
AGGACCTCAT	GAATTTTGCT	CTCAACATAC	AATGCTAGTT
ATGATTATGT	GTACCTTCCT	TACCCAGATC	CATCAAGAAT
GGCTGTTTTG	TAGATGATAT	CGTAAAAACA	GATGGTACAC
ACGGTTCGTG	TCTTTAGCTA	TAGATGCTTA	CCCACTTACT
ATCAGGAGTA	TGCTGATGTC	TTTCATTTGT	ACTTACAATA
CTACATGATG	AGTTAACAGG	ACACATGTTA	GACATGTATT
TACTAATGAT	AACACTTCAA	GGTATTGGGA	ACCTGAGTTT
TGTACACACC	GCATACAGTC	TTACAGGCTG	TTGGGGCTTG
AATTCACAGA	CTTCATTAAG	ATGTGGTGCT	TGCATACGTA
ATGTTGTAAA	TGCTGTTACG	ACCATGTCAT	ATCAACATCA
TCTTGTCTGT	TAATCCGTAT	GTTTGCAATG	CTCCAGGTTG
GATGTGACTC	AACTTTACTT	AGGAGGTATG	AGCTATTATT
TAAACCACCC	ATTAGTTTTC	CATTGTGTGC	TAATGGACAA
TATATAAAAA	TACATGTGTT	GGTAGCGATA	ATGTTACTGA
ATTGCAACAT	GTGACTGGAC	AAATGCTGGT	GATTACATTT
CTGTACTGAA	AGACTCAAGC	TTTTTGCAGC	AGAAACGCTC
AGGAGACATT	TAAACTGTCT	TATGGTATTG	CTACTGTACG
TCTGACAGAG	AATTACATCT	TTCATGGGAA	GTTGGTAAAC
ACTTAACCGA	AATTATGTCT	TTACTGGTTA	TCGTGTAACT
AAGTACAAAT	AGGAGAGTAC	ACCTTTGAAA	AAGGTGACTA
GTTGTTTACC	GAGGTACAAC	AACTTACAAA	TTAAATGTTG
TGTGCTGACA	TCACATACAG	TAATGCCATT	AAGTGCACCT
CACAAGAGCA	CTATGTTAGA	ATTACTGGCT	TATACCCAAC
TCAGATGAGT	TTTCTAGCAA	TGTTGCAAAT	TATCAAAAGG
AAAGTATTCT	ACACTCCAGG	GACCACCTGG	TACTGGTAAG
CTATTGGCCT	AGCTCTCTAC	TACCCTTCTG	CTCGCATAGT
TGCTCTCATG	CCGCTGTTGA	TGCACTATGT	GAGAAGGCAT
GCCTATAGAT	AAATGTAGTA	GAATTATACC	TGCACGTGCT
GTTTTGATAA	ATTCAAAGTG	AATTCAACAT	TAGAACAGTA
ACTGTAAATG	CATTGCCTGA	GACGACAGCA	GATATAGTTG
AATTTCAATG	GCCACAAATT	ATGATTTGAG	TGTTGTCAAT
GTGCTAAGCA	CTATGTGTAC	ATTGGCGACC	CTGCTCAATT
CGCACATTGC	TAACTAAGGG	CACACTAGAA	CCAGAATATT
GTGTAGACTT	ATGAAAACTA	TAGGTCCAGA	CATGTTCCTC
GGCGTTGTCC	TGCTGAAATT	GTTGACACTG	TGAGTGCTTT
AATAAGCTTA	AAGCACATAA	AGACAAATCA	GCTCAATGCT
TTATAAGGGT	GTTATCACGC	ATGATGTTTC	ATCTGCAATT
AAATAGGCGT	GGTAAGAGAA	TTCCTTACAC	GTAACCCTGC
GCTGTCTTTA	TTTCACCTTA	TAATTCACAG	AATGCTGTAG
TTTGGGACTA	CCAACTCAAA	CTGTTGATTC	ATCACAGGGC
ACTATGTCAT	ATTCACTCAA	ACCACTGAAA	CAGCTCACTC
AACAGATTTA	ATGTTGCTAT	TACCAGAGCA	AAAGTAGGCA
AATGTCTGAT	AGAGACCTTT	ATGACAAGTT	GCAATTTACA
TTCCACGTAG	GAATGTGGCA	ACTTTACAAG	CTGAAAATGT
TTTAAAGATT	GTAGTAAGGT	AATCACTGGG	TTACATCCTA
TACACACCTC	AGTGTTGACA	CTAAATTCAA	AACTGAAGGT
ACATACCTGG	CATACCTAAG	GACATGACCT	ATAGAAGACT
ATGGGTTTTA	AAATGAATTA	TCAAGTTAAT	GGTTACCCTA
CACCCGCGAA	GAAGCTATAA	GACATGTACG	TGCATGGATT
TCGAGGGGTG	TCATGCTACT	AGAGAAGCTG	TTGGTACCAA
CAGCTAGGTT	TTTCTACAGG	TGTTAACCTA	GTTGCTGTAC
TGTTGATACA	CCTAATAATA	CAGATTTTTC	CAGAGTTAGT
CGCCTGGAGA	TCAATTTAAA	CACCTCATAC	CACTTATGTA
CCTTGGAATG	TAGTGCGTAT	AAAGATTGTA	CAAATGTTAA
TAAAAATCTC	TCTGACAGAG	TCGTATTTGT	CTTATGGGCA
AGTTGACATC	TATGAAGTAT	TTTGTGAAAA	TAGGACCTGA
TGTCTATGTG	ATAGACGTGC	CACATGCTTT	TCCACTGCTT
TGCCTGTTGG	CATCATTCTA	TTGGATTTGA	TTACGTCTAT
TGATTGATGT	TCAACAATGG	GGTTTTACAG	GTAACCTACA
GATCTGTATT	GTCAAGTCCA	TGGTAATGCA	CATGTAGCTA
AATCATGACT	AGGTGTCTAG	CTGTCCACGA	GTGCTTTGTT
ACTGGACTAT	TGAATATCCT	ATAATTGGTG	ATGAACTGAA
GCTTGTAGAA	AGGTTCAACA	CATGGTTGTT	AAAGCTGCAT
CAAATTCCCA	GTTCTTCACG	ACATTGGTAA	CCCTAAAGCT
TACCTCAAGC	TGATGTAGAA	TGGAAGTTCT	ATGATGCACA
GACAAAGCTT	ATAAAATAGA	AGAATTATTC	TATTCTTATG
TGACAAATTC	ACAGATGGTG	TATGCCTATT	TTGGAATTGC
GATATCCTGC	TAATTCCATT	GTTTGTAGAT	TTGACACTAG
AACCTTAACT	TGCCTGGTTG	TGATGGTGGC	AGTTTGTATG
TGCATTCCAC	ACACCAGCTT	TTGATAAAAG	TGCTTTTGTT
AATTACCATT	TTTCTATTAC	TCTGACAGTC	CATGTGAGTC
CAAGTAGTGT	CAGATATAGA	TTATGTACCA	CTAAAGTCTG
AACACGTTGC	AATTTAGGTG	GTGCTGTCTG	TAGACATCAT
ACAGATTGTA	TCTCGATGCT	TATAACATGA	TGATCTCAGC
TTGTGGGTTT	ACAAACAATT	TGATACTTAT	AACCTCTGGA
AAGACTTCAG	AGTTTAGAAA	ATGTGGCTTT	TAATGTTGTA
ACTTTGATGG	ACAACAGGGT	GAAGTACCAG	TTTCTATCAT
GTTTACACAA	AAGTTGATGG	TGTTGATGTA	GAATTGTTTG
AACATTACCT	GTTAATGTAG	CATTTGAGCT	TTGGGCTAAG
AACCAGTACC	AGAGGTGAAA	ATACTCAATA	ATTTGGGTGT
GCTAATACTG	TGATCTGGGA	CTACAAAAGA	GATGCTCCAG
TACTATTGGT	GTTTGTTCTA	TGACTGACAT	AGCCAAGAAA
CGATTTGTGC	ACCACTCACT	GTCTTTTTTG	ATGGTAGAGT
GTAGACTTAT	TTAGAAATGC	CCGTAATGGT	GTTCTTATTA
TGTTAAAGGT	TTACAACCAT	CTGTAGGTCC	CAAACAAGCT
GAGTCACATT	AATTGGAGAA	GCCGTAAAAA	CACAGTTCAA
AAAGTTGATG	GTGTTGTCCA	ACAATTACCT	GAAACTTACT
TAGAAATTTA	CAAGAATTTA	AACCCAGGAG	TCAAATGGAA
TAGAATTAGC	TATGGATGAA	TTCATTGAAC	GGTATAAATT
GCCTTCGAAC	ATATCGTTTA	TGGAGATTTT	AGTCATAGTC
TTTACATCTA	CTGATTGGAC	TAGCTAAACG	TTTTAAGGAA
AATTAGAAGA	TTTTATTCCT	ATGGACAGTA	CAGTTAAAAA
ACAGATGCGC	AAACAGGTTC	ATCTAAGTGT	GTGTGTTCTG
ATTACTTGAT	GATTTTGTTG	AAATAATAAA	ATCCCAAGAT
TTTCTAAGGT	TGTCAAAGTG	ACTATTGACT	ATACAGAAAT
CTTTGGTGTA	AAGATGGCCA	TGTAGAAACA	TTTTACCCAA
TAGTCAAGCG	TGGCAACCGG	GTGTTGCTAT	GCCTAATCTT
AAAGAATGCT	ATTAGAAAAG	TGTGACCTTC	AAAATTATGG
ACATTACCTA	AAGGCATAAT	GATGAATGTC	GCAAAATATA
TCAATATTTA	AACACATTAA	CATTAGCTGT	ACCCTATAAT
TACATTTTGG	TGCTGGTTCT	GATAAAGGAG	TTGCACCAGG
TTAAGACAGT	GGTTGCCTAC	GGGTACGCTG	CTTGTCGATT
TGACTTTGTC	TCTGATGCAG	ATTCAACTTT	GATTGGTGAT
TACATACAGC	TAATAAATGG	GATCTCATTA	TTAGTGATAT
AAGACTAAAA	ATGTTACAAA	AGAAAATGAC	TCTAAAGAGG
TTACATTTGT	GGGTTTATAC	AACAAAAGCT	AGCTCTTGGA
CTATAAAGAT	AACAGAACAT	TCTTGGAATG	CTGATCTTTA
GGACACTTCG	CATGGTGGAC	AGCCTTTGTT	ACTAATGTGA
ATCTGAAGCA	TTTTTAATTG	GATGTAATTA	TCTTGGCAAA
AAATAGATGG	TTATGTCATG	CATGCAAATT	ACATATTTTG
AATCCAATTC	AGTTGTCTTC	CTATTCTTTA	TTTGACATGA
CCTTAAATTA	AGGGGTACTG	CTGTTATGTC	TTTAAAAGAA
ATGATATGAT	TTTATCTCTT	CTTAGTAAAG	GTAGACTTAT
AACAACAGAG	TTGTTATTTC	TAGTGATGTT	CTTGTTAACA
CAATGTTTGT	TTTTCTTGTT	TTATTGCCAC	TAGTCTCTAG
AATCTTACAA	CCAGAACTCA	ATTACCCCCT	GCATACACTA
ACGTGGTGTT	TATTACCCTG	ACAAAGTTTT	CAGATCCTCA
CAACTCAGGA	CTTGTTCTTA	CCTTTCTTTT	CCAATGTTAC
GCTATACATG	TCTCTGGGAC	CAATGGTACT	AAGAGGTTTG
CCTACCATTT	AATGATGGTG	TTTATTTTGC	TTCCACTGAG
TAATAAGAGG	CTGGATTTTT	GGTACTACTT	TAGATTCGAA
CTACTTATTG	TTAATAACGC	TACTAATGTT	GTTATTAAAG
TCAATTTTGT	AATGATCCAT	TTTTGGGTGT	TTATTACCAC
AAAGTTGGAT	GGAAAGTGAG	TTCAGAGTTT	ATTCTAGTGC
ACTTTTGAAT	ATGTCTCTCA	GCCTTTTCTT	ATGGACCTTG
GGGTAATTTC	AAAAATCTTA	GGGAATTTGT	GTTTAAGAAT
ATTTTAAAAT	ATATTCTAAG	CACACGCCTA	TTAATTTAGT
CCTCAGGGTT	TTTCGGCTTT	AGAACCATTG	GTAGATTTGC
TAACATCACT	AGGTTTCAAA	CTTTACTTGC	TTTACATAGA
CTCCTGGTGA	TTCTTCTTCA	GGTTGGACAG	CTGGTGCTGC
GTGGGTTATC	TTCAACCTAG	GACTTTTCTA	TTAAAATATA
AACCATTACA	GATGCTGTAG	ACTGTGCACT	TGACCCTCTC
AGTGTACGTT	GAAATCCTTC	ACTGTAGAAA	AAGGAATCTA
AACTTTAGAG	TCCAACCAAC	AGAATCTATT	GTTAGATTTC
AAACTTGTGC	CCTTTTGGTG	AAGTTTTTAA	CGCCACCAGA
TTTATGCTTG	GAACAGGAAG	AGAATCAGCA	ACTGTGTTGC
GTCCTATATA	ATTCCGCATC	ATTTTCCACT	TTTAAGTGTT
TCCTACTAAA	TTAAATGATC	TCTGCTTTAC	TAATGTCTAT
TTGTAATTAG	AGGTGATGAA	GTCAGACAAA	TCGCTCCAGG
AAGATTGCTG	ATTATAATTA	TAAATTACCA	GATGATTTTA
TATAGCTTGG	AATTCTAACA	ATCTTGATTC	TAAGGTTGGT
ATTACCTGTA	TAGATTGTTT	AGGAAGTCTA	ATCTCAAACC
GATATTTCAA	CTGAAATCTA	TCAGGCCGGT	AGCACACCTT
TGAAGGTTTT	AATTGTTACT	TTCCTTTACA	ATCATATGGT
CTAATGGTGT	TGGTTACCAA	CCATACAGAG	TAGTAGTACT
CTTCTACATG	CACCAGCAAC	TGTTTGTGGA	CCTAAAAAGT
GGTTAAAAAC	AAATGTGTCA	ATTTCAACTT	CAATGGTTTA
GTGTTCTTAC	TGAGTCTAAC	AAAAAGTTTC	TGCCTTTCCA
AGAGACATTG	CTGACACTAC	TGATGCTGTC	CGTGATCCAC
GATTCTTGAC	ATTACACCAT	GTTCTTTTGG	TGGTGTCAGT
CAGGAACAAA	TACTTCTAAC	CAGGTTGCTG	TTCTTTATCA
TGCACAGAAG	TCCCTGTTGC	TATTCATGCA	GATCAACTTA
GCGTGTTTAT	TCTACAGGTT	CTAATGTTTT	TCAAACACGT
TAATAGGGGC	TGAACATGTC	AACAACTCAT	ATGAGTGTGA
GGTGCAGGTA	TATGCGCTAG	TTATCAGACT	CAGACTAATT
GGCACGTAGT	GTAGCTAGTC	AATCCATCAT	TGCCTACACT
GTGCAGAAAA	TTCAGTTGCT	TACTCTAATA	ACTCTATTGC
AATTTTACTA	TTAGTGTTAC	CACAGAAATT	CTACCAGTGT
GACATCAGTA	GATTGTACAA	TGTACATTTG	TGGTGATTCA
GCAATCTTTT	GTTGCAATAT	GGCAGTTTTT	GTACACAATT
TTAACTGGAA	TAGCTGTTGA	ACAAGACAAA	AACACCCAAG
ACAAGTCAAA	CAAATTTACA	AAACACCACC	AATTAAAGAT
TTAATTTTTC	ACAAATATTA	CCAGATCCAT	CAAAACCAAG
TTTATTGAAG	ATCTACTTTT	CAACAAAGTG	ACACTTGCAG
CATCAAACAA	TATGGTGATT	GCCTTGGTGA	TATTGCTGCT
TTTGTGCACA	AAAGTTTAAC	GGCCTTACTG	TTTTGCCACC
GATGAAATGA	TTGCTCAATA	CACTTCTGCA	CTGTTAGCGG
TTCTGGTTGG	ACCTTTGGTG	CAGGTGCTGC	ATTACAAATA
TGCAAATGGC	TTATAGGTTT	AATGGTATTG	GAGTTACACA
TATGAGAACC	AAAAATTGAT	TGCCAACCAA	TTTAATAGTG
AATTCAAGAC	TCACTTTCTT	CCACAGCAAG	TGCACTTGGA
ATGTGGTCAA	CCAAAATGCA	CAAGCTTTAA	ACACGCTTGT
AGCTCCAATT	TTGGTGCAAT	TTCAAGTGTT	TTAAATGATA
TCTTGACAAA	GTTGAGGCTG	AAGTGCAAAT	TGATAGGTTG
GACTTCAAAG	TTTGCAGACA	TATGTGACTC	AACAATTAAT
GAAATCAGAG	CTTCTGCTAA	TCTTGCTGCT	ACTAAAATGT
ACTTGGACAA	TCAAAAAGAG	TTGATTTTTG	TGGAAAGGGC
TGTCCTTCCC	TCAGTCAGCA	CCTCATGGTG	TAGTCTTCTT
TATGTCCCTG	CACAAGAAAA	GAACTTCACA	ACTGCTCCTG
TGATGGAAAA	GCACACTTTC	CTCGTGAAGG	TGTCTTTGTT
CACACTGGTT	TGTAACACAA	AGGAATTTTT	ATGAACCACA
ACAGACAACA	CATTTGTGTC	TGGTAACTGT	GATGTTGTAA
CAACAACACA	GTTTATGATC	CTTTGCAACC	TGAATTAGAC
AGGAGTTAGA	TAAATATTTT	AAGAATCATA	CATCACCAGA
GGTGACATCT	CTGGCATTAA	TGCTTCAGTT	GTAAACATTC
TGACCGCCTC	AATGAGGTTG	CCAAGAATTT	AAATGAATCT
TCCAAGAACT	TGGAAAGTAT	GAGCAGTATA	TAAAATGGCC
TGGCTAGGTT	TTATAGCTGG	CTTGATTGCC	ATAGTAATGG
GCTTTGCTGT	ATGACCAGTT	GCTGTAGTTG	TCTCAAGGGC
GTGGATCCTG	CTGCAAATTT	GATGAAGACG	ACTCTGAGCC
GGAGTCAAAT	TACATTACAC	ATAAACGAAC	TTATGGATTT
ATCTTCACAA	TTGGAACTGT	AACTTTGAAG	CAAGGTGAAA
TACTCCTTCA	GATTTTGTTC	GCGCTACTGC	AACGATACCG
CACTCCCTTT	CGGATGGCTT	ATTGTTGGCG	TTGCACTTCT
CAGAGCGCTT	CCAAAATCAT	AACCCTCAAA	AAGAGATGGC
CTCCAAGGGT	GTTCACTTTG	TTTGCAACTT	GCTGTTGTTG
TTTACTCACA	CCTTTTGCTC	GTTGCTGCTG	GCCTTGAAGC
TATCTTTATG	CTTTAGTCTA	CTTCTTGCAG	AGTATAAACT
AATAATGAGG	CTTTGGCTTT	GCTGGAAATG	CCGTTCCAAA
TTTATGATGC	CAACTATTTT	CTTTGCTGGC	ATACTAATTG
TGTATACCTT	ACAATAGTGT	AACTTCTTCA	ATTGTCATTA
TGGCACAACA	AGTCCTATTT	CTGAACATGA	CTACCAGATT
CTGAAAAATG	GGAATCTGGA	GTAAAAGACT	GTGTTGTATT
TTCACTTCAG	ACTATTACCA	GCTGTACTCA	ACTCAATTGA
TGGTGTTGAA	CATGTTACCT	TCTTCATCTA	CAATAAAATT
CTGAAGAACA	TGTCCAAATT	CACACAATCG	ACGGTTCATC
AATCCAGTAA	TGGAACCAAT	TTATGATGAA	CCGACGACGA
GCCTTTGTAA	GCACAAGCTG	ATGAGTACGA	ACTTATGTAC
CGGAAGAGAC	AGGTACGTTA	ATAGTTAATA	GCGTACTTCT
TTCGTGGTAT	TCTTGCTAGT	TACACTAGCC	ATCCTTACTG
GTGTGCGTAC	TGCTGCAATA	TTGTTAACGT	GAGTCTTGTA
TTTACGTTTA	CTCTCGTGTT	AAAAATCTGA	ATTCTTCTAG
CTTCTGGTCT	AAACGAACTA	AATATTATAT	TAGTTTTTCT
TTAATTTTAG	CCATGGCAGA	TTCCAACGGT	ACTATTACCG
TAAAAAGCTC	CTTGAACAAT	GGAACCTAGT	AATAGGTTTC
CATGGATTTG	TCTTCTACAA	TTTGCCTATG	CCAACAGGAA
TATATAATTA	AGTTAATTTT	CCTCTGGCTG	TTATGGCCAG
TTGTTTTGTG	CTTGCTGCTG	TTTACAGAAT	AAATTGGATC
TTGCTATCGC	AATGGCTTGT	CTTGTAGGCT	TGATGTGGCT
ATTGCTTCTT	TCAGACTGTT	TGCGCGTACG	CGTTCCATGT
TCCAGAAACT	AACATTCTTC	TCAACGTGCC	ACTCCATGGC
CCAGACCGCT	TCTAGAAAGT	GAACTCGTAA	TCGGAGCTGT
GGACATCTTC	GTATTGCTGG	ACACCATCTA	GGACGCTGTG
CCTGCCTAAA	GAAATCACTG	TTGCTACATC	ACGAACGCTT
AATTGGGAGC	TTCGCAGCGT	GTAGCAGGTG	ACTCAGGTTT
AGTCGCTACA	GGATTGGCAA	CTATAAATTA	AACACAGACC
CAGTGACAAT	ATTGCTTTGC	TTGTACAGTA	AGTGACAACA
CTCGTTGACT	TTCAGGTTAC	TATAGCAGAG	ATATTACTAA
GACTTTTAAA	GTTTCCATTT	GGAATCTTGA	TTACATCATA
TTAAAAATTT	ATCTAAGTCA	CTAACTGAGA	ATAAATATTC
GAAGAGCAAC	CAATGGAGAT	TGATTAAACG	AACATGAAAA
CTTGGCACTG	ATAACACTCG	CTACTTGTGA	GCTTTATCAC
GTGTTAGAGG	TACAACAGTA	CTTTTAAAAG	AACCTTGCTC
TACGAGGGCA	ATTCACCATT	TCATCCTCTA	GCTGATAACA
GACTTGCTTT	AGCACTCAAT	TTGCTTTTGC	TTGTCCTGAC
ACGTCTATCA	GTTACGTGCC	AGATCAGTTT	CACCTAAACT
CAAGAGGAAG	TTCAAGAACT	TTACTCTCCA	ATTTTTCTTA
AATAGTGTTT	ATAACACTTT	GCTTCACACT	CAAAAGAAAG
TGAACTTTCA	TTAATTGACT	TCTATTTGTG	CTTTTTAGCC
TCCTTGTTTT	AATTATGCTT	ATTATCTTTT	GGTTCTCACT
GATCATAATG	AAACTTGTCA	CGCCTAAACG	AACATGAAAT
CTTAGGAATC	ATCACAACTG	TAGCTGCATT	TCACCAAGAA
AGTCATGTAC	TCAACATCAA	CCATATGTAG	TTGATGACCC
CACTTCTATT	CTAAATGGTA	TATTAGAGTA	GGAGCTAGAA
TTTAATTGAA	TTGTGCGTGG	ATGAGGCTGG	TTCTAAATCA
ACATCGATAT	CGGTAATTAT	ACAGTTTCCT	GTTTACCTTT
TGCCAGGAAC	CTAAATTGGG	TAGTCTTGTA	GTGCGTTGTT
AGACTTTTTA	GAGTATCATG	ACGTTCGTGT	TGTTTTAGAT
CGAACAAACT	AAAATGTCTG	ATAATGGACC	CCAAAATCAG
CCCGCATTAC	GTTTGGTGGA	CCCTCAGATT	CAACTGGCAG
GGAGAACGCA	GTGGGGCGCG	ATCAAAACAA	CGTCGGCCCC
CAATAATACT	GCGTCTTGGT	TCACCGCTCT	CACTCAACAT
ACCTTAAATT	CCCTCGAGGA	CAAGGCGTTC	CAATTAACAC
CCAGATGACC	AAATTGGCTA	CTACCGAAGA	GCTACCAGAC
TGGTGACGGT	AAAATGAAAG	ATCTCAGTCC	AAGATGGTAT
TAGGAACTGG	GCCAGAAGCT	GGACTTCCCT	ATGGTGCTAA
ATCATATGGG	TTGCAACTGA	GGGAGCCTTG	AATACACCAA
TGGCACCCGC	AATCCTGCTA	ACAATGCTGC	AATCGTGCTA
AAGGAACAAC	ATTGCCAAAA	GGCTTCTACG	CAGAAGGGAG
AGTCAAGCCT	CTTCTCGTTC	CTCATCACGT	AGTCGCAACA
TTCAACTCCA	GGCAGCAGTA	GGGGAACTTC	TCCTGCTAGA
ATGGCGGTGA	TGCTGCTCTT	GCTTTGCTGC	TGCTTGACAG
CTTGAGAGCA	AAATGTCTGG	TAAAGGCCAA	CAACAACAAG
CACTAAGAAA	TCTGCTGCTG	AGGCTTCTAA	GAAGCCTCGG
CTGCCACTAA	AGCATACAAT	GTAACACAAG	CTTTCGGCAG
GAACAAACCC	AAGGAAATTT	TGGGGACCAG	GAACTAATCA
TGATTACAAA	CATTGGCCGC	AAATTGCACA	ATTTGCCCCC
CGTTCTTCGG	AATGTCGCGC	ATTGGCATGG	AAGTCACACC
TGGTTGACCT	ACACAGGTGC	CATCAAATTG	GATGACAAAG
CAAAGATCAA	GTCATTTTGC	TGAATAAGCA	TATTGACGCA
TCCCACCAAC	AGAGCCTAAA	AAGGACAAAA	AGAAGAAGGC
CAAGCCTTAC	CGCAGAGACA	GAAGAAACAG	CAAACTGTGA
TGCTGCAGAT	TTGGATGATT	TCTCCAAACA	ATTGCAACAA
GTGCTGACTC	AACTCAGGCC	TAAACTCATG	CAGACCACAC
GGCTATATAA	ACGTTTTCGC	TTTTCCGTTT	ACGATATATA
GTGCAGAATG	AATTCTCGTA	ACTACATAGC	ACAAGTAGAT
TTAATCTCAC	ATAGCAATCT	TTAATCAGTG	TGTAACATTA
GAAAGAGCCA	CCACATTTTC	ACCGAGGCCA	CGCGGAGTAC
ACAGTGAACA	ATGCTAGGGA	GAGCTGCCTA	TATGGAAGAG
TAAAATTAAT	TTTAGTAGTG	CTATCCCCAT	GTGATTTTAA
GGAGAATGAC	AAAAAAAAAA	AAAAAAAAAA	AAAAAAAAAA
